20 20
2 0 0 0 0 0 0 0 0 0 0 1 0 0 0 0 0 0 0 0
5 0 0 0 0 0 0 0 0 0 0 1 0 0 6 5 5 5 5 5
5 0 0 0 0 0 0 0 0 0 0 1 0 0 5 0 0 0 0 5
5 0 0 0 0 0 0 0 0 1 1 1 1 1 5 0 0 0 0 5
5 5 5 5 5 5 5 0 0 0 0 1 0 0 5 0 0 0 0 5
0 0 0 0 0 0 6 0 0 0 0 1 0 0 5 0 0 0 0 5
0 0 0 0 0 0 5 0 0 0 0 0 0 0 5 0 0 0 0 5
0 0 0 0 0 0 5 0 0 0 0 0 0 0 5 0 0 0 0 5
0 0 0 0 0 0 5 0 0 0 0 0 0 0 5 0 0 0 0 5
0 0 0 0 0 0 5 0 0 0 0 0 0 0 5 0 0 0 0 5
0 0 0 0 0 0 5 0 0 0 0 0 0 0 5 0 0 0 0 5
0 0 0 0 5 5 6 0 0 0 0 0 0 0 5 0 0 0 0 5
0 0 0 0 5 0 0 0 0 0 0 0 0 0 5 0 0 0 0 5
0 0 0 0 5 0 0 0 0 0 0 0 0 0 5 0 0 0 0 5
0 0 0 0 6 5 5 5 5 5 0 0 0 0 5 0 0 0 0 5
0 0 0 0 0 0 0 0 0 5 5 5 5 5 6 0 0 0 0 5
0 0 0 0 0 0 0 0 0 0 0 0 0 0 0 0 0 0 0 5
0 0 0 0 0 0 0 0 0 0 0 0 0 0 0 0 0 0 0 5
0 0 0 0 0 0 0 0 0 0 0 0 0 0 0 0 0 0 0 5
0 0 0 0 0 0 0 0 0 0 0 0 0 0 0 0 0 0 0 3
